000000000
000000000
000000000
000000000
000000000
000000000
000000000
000000000
000000000
000000000
110000011
100000001